3 3 3 4 3 3 3 3 3 3 4 3 3 3 3 3 3 3 3 3 3 3 3 3 3 3 3 3 3 3 3 4 3 3 3 3 3 3 3 3 3 3 3 3 4 3 3 3 3 4
3 3 3 4 3 3 3 3 4 3 3 3 3 3 3 3 3 4 3 3 3 3 3 3 3 3 3 3 4 3 3 3 3 3 3 4 3 3 4 3 3 3 3 3 3 3 3 4 3 3
3 3 3 3 3 4 3 3 3 3 3 3 3 3 4 3 3 3 3 3 3 3 4 3 3 3 3 3 3 3 3 3 4 3 3 3 3 3 3 3 3 3 4 3 4 3 3 3 4 3
3 3 3 3 3 3 3 3 4 3 3 3 3 3 3 3 3 3 3 4 3 3 3 3 3 3 4 3 3 3 3 3 3 3 3 4 3 3 3 3 4 3 3 3 3 3 4 3 3 3
3 3 4 3 15 14 14 14 14 14 14 14 14 14 14 14 14 14 14 14 14 14 14 14 14 14 14 14 14 14 14 14 14 14 14 14 14 14 14 14 14 14 14 14 14 16 3 3 3 4
4 4 3 3 17 6 5 5 5 5 5 5 5 5 5 5 5 5 5 5 5 5 5 5 5 5 5 5 5 5 5 5 5 5 5 5 5 5 5 5 5 5 5 5 7 18 3 4 3 3
4 3 3 4 17 8 0 0 0 0 1 1 2 1 1 1 1 2 2 1 1 2 1 1 2 1 0 0 0 0 0 0 0 0 0 2 1 2 1 0 0 0 0 0 9 18 4 3 3 3
3 3 3 3 17 8 0 0 0 26 27 28 41 41 41 41 41 41 41 42 1 2 0 0 0 55 54 54 54 54 54 54 54 54 54 54 54 54 54 54 56 1 0 0 9 18 3 3 4 3
3 3 3 3 17 8 0 0 0 29 30 31 39 39 39 44 39 39 39 40 2 1 0 0 0 50 52 52 52 52 52 52 52 52 52 52 52 52 52 52 51 0 0 0 9 18 3 3 3 3
3 3 4 3 17 8 0 0 1 32 33 34 44 39 43 39 39 44 39 40 1 0 0 0 2 50 52 52 52 52 52 52 52 52 52 52 52 52 52 52 51 0 0 0 9 18 4 3 3 3
3 3 3 3 17 8 0 0 1 37 13 39 39 39 39 39 39 39 39 40 2 0 0 0 1 50 52 52 52 52 52 52 52 52 52 52 52 52 52 52 51 1 0 0 9 18 3 3 4 3
3 3 3 4 17 8 0 0 1 37 13 39 39 43 39 39 44 39 39 40 1 2 0 0 0 50 52 52 52 52 52 52 52 52 52 52 52 52 52 52 51 1 0 0 9 18 3 3 3 3
3 3 3 3 17 8 0 0 0 37 13 13 39 39 43 39 39 43 39 40 0 1 2 0 0 50 52 52 52 52 52 52 52 52 52 52 52 52 52 52 51 2 0 0 9 18 3 4 3 3
4 3 3 3 17 8 0 0 0 37 39 13 39 39 39 39 39 39 39 40 0 0 2 1 0 50 52 52 52 52 52 52 52 52 52 52 52 52 52 52 51 2 0 0 9 18 3 3 3 3
3 3 4 3 17 8 0 0 2 36 35 13 35 35 35 35 35 35 35 38 0 2 1 2 1 50 52 52 52 52 52 52 52 52 52 52 52 52 52 52 51 1 0 0 9 18 3 3 3 4
3 3 3 3 17 8 0 0 1 2 1 13 2 1 2 1 2 0 0 0 0 1 2 2 1 50 52 52 52 52 52 52 52 52 52 52 52 52 52 52 51 2 0 0 9 18 4 3 3 3
3 3 3 3 17 8 0 0 0 0 2 13 2 1 0 0 0 0 2 0 0 0 0 1 1 48 47 47 47 47 47 47 47 47 47 53 47 47 47 47 49 2 0 0 9 18 3 4 3 4
3 3 4 3 17 8 0 0 2 0 1 13 1 2 1 2 0 0 0 0 0 0 0 0 2 2 1 2 2 1 2 2 1 2 1 13 2 1 2 0 0 0 0 0 9 18 3 4 3 3
3 3 3 4 17 8 0 0 0 2 1 13 13 13 13 13 13 2 0 0 0 1 2 1 2 2 1 1 2 1 2 2 1 1 2 13 1 2 0 0 0 0 0 0 9 18 3 3 3 4
4 3 4 3 17 8 0 0 0 0 1 1 2 1 2 1 13 0 0 0 0 0 0 1 1 2 1 2 2 1 1 2 13 13 13 13 2 0 0 0 0 0 0 0 9 18 4 3 3 3
3 3 3 3 17 8 0 0 0 0 0 0 1 0 0 1 13 2 0 0 0 0 0 0 0 0 1 2 1 2 1 2 13 0 0 0 0 0 0 0 0 0 0 0 9 18 4 3 3 3
3 3 3 3 17 8 0 0 2 0 0 0 0 0 1 2 13 2 1 0 0 0 0 1 2 2 1 2 1 1 2 1 13 2 2 0 0 0 0 0 0 0 0 0 9 18 3 4 3 4
3 3 4 3 17 8 0 0 0 0 0 0 2 0 0 1 13 13 13 13 13 1 1 2 22 24 1 2 2 1 2 1 13 1 2 1 0 0 0 0 0 0 0 0 9 18 3 4 3 3
3 3 3 4 17 8 0 0 0 0 0 2 0 0 0 2 1 2 1 2 13 1 2 2 23 25 1 2 2 1 13 13 13 0 0 0 0 0 0 0 0 0 0 0 9 18 3 3 3 4
4 3 3 3 17 8 0 0 0 0 0 0 0 0 0 0 0 1 2 1 13 13 13 13 13 13 13 13 13 13 13 0 0 0 0 0 0 0 0 0 0 0 0 0 9 18 4 3 3 3
3 3 3 3 17 8 0 0 0 0 0 0 0 0 2 2 0 0 0 0 0 0 0 13 13 13 13 2 2 1 0 0 0 0 0 0 0 0 0 0 0 0 0 0 9 18 4 3 3 3
3 3 4 3 17 8 0 0 0 0 0 0 0 0 0 0 0 0 0 0 0 2 13 13 13 13 13 13 13 13 13 13 1 2 0 0 0 0 0 0 0 0 0 0 9 18 3 4 3 4
3 3 4 3 17 8 0 0 2 0 0 0 2 1 2 0 1 0 1 2 0 2 13 0 2 0 0 2 0 0 0 13 0 0 0 0 0 0 0 0 0 0 0 0 9 18 3 4 3 3
3 3 3 4 17 8 0 0 13 13 13 13 13 13 13 13 13 13 13 13 13 13 13 2 0 0 0 0 0 0 0 13 13 13 0 0 0 0 0 0 0 0 0 0 9 18 3 3 4 4
4 3 3 3 17 8 0 0 2 13 0 0 0 0 2 13 13 13 2 1 0 0 0 0 0 0 0 0 0 0 0 0 2 13 46 1 0 0 0 2 0 0 0 0 9 18 3 3 3 3
3 3 3 3 17 8 0 0 13 13 0 0 0 0 0 2 13 13 2 0 0 0 0 0 0 0 0 0 0 0 0 0 0 46 13 13 2 0 0 0 0 0 0 0 9 18 3 3 3 3
3 3 3 3 17 8 0 0 13 0 0 0 0 0 2 0 1 13 0 0 0 2 0 0 0 0 0 0 0 0 2 0 0 2 13 13 46 0 0 0 0 0 0 0 9 18 3 4 3 4
3 3 4 3 17 8 0 0 13 0 0 0 0 0 0 0 0 13 1 0 0 0 0 0 0 0 0 0 0 0 0 0 0 13 46 13 13 13 2 0 0 0 0 0 9 18 3 4 3 3
4 3 3 4 17 8 0 0 13 0 2 0 0 0 0 0 0 13 2 0 0 0 0 0 0 0 0 0 0 0 0 0 2 2 13 46 13 13 13 46 2 0 0 0 9 18 3 3 3 3
3 3 4 3 17 8 0 0 2 0 0 0 0 0 0 0 0 13 0 0 0 0 0 0 0 2 0 0 0 0 0 0 13 13 46 13 13 46 13 1 0 0 0 0 9 18 3 3 3 3
3 3 3 3 17 8 0 0 1 2 1 0 0 0 0 2 1 13 13 13 13 0 0 0 0 0 0 0 0 46 13 13 13 46 13 13 2 0 0 0 2 0 0 0 9 18 4 3 3 3
3 4 3 3 17 8 0 0 1 2 0 0 0 0 0 2 13 13 1 0 13 1 0 0 2 0 0 0 0 0 2 13 46 13 46 13 13 0 0 0 0 0 0 0 9 18 3 3 3 4
3 3 4 3 17 8 0 0 2 0 0 1 2 1 13 13 13 13 0 0 0 2 0 0 0 2 0 0 0 0 13 13 46 13 46 13 46 46 2 0 0 0 0 0 9 18 3 4 3 3
3 3 3 4 17 8 0 0 1 0 1 2 0 0 0 1 2 13 0 0 0 2 0 0 0 0 0 0 0 0 0 0 13 13 13 46 13 2 0 0 0 0 0 0 9 18 3 3 4 4
3 3 3 4 17 8 0 0 0 0 0 0 0 0 0 0 1 13 0 2 1 0 0 0 0 0 0 0 0 0 0 2 0 0 46 13 13 13 0 0 0 0 0 0 9 18 4 3 3 3
3 3 4 3 17 8 0 0 0 0 0 2 1 0 0 0 2 13 0 2 0 0 0 0 0 0 1 13 13 13 13 13 0 46 13 13 46 13 13 46 1 0 0 0 9 18 3 4 3 4
3 3 4 3 17 8 0 0 0 2 1 13 13 13 13 13 13 13 13 13 13 13 13 13 13 13 13 13 0 2 1 13 13 46 13 46 13 45 13 46 2 0 0 0 9 18 3 4 3 3
3 3 3 4 17 8 0 0 0 0 0 0 13 13 1 1 0 2 2 1 0 0 1 0 0 0 1 2 0 0 0 1 2 2 0 13 46 13 46 13 46 1 0 0 9 18 3 3 4 4
4 3 3 3 17 8 0 0 0 0 0 0 2 1 0 2 0 0 0 0 0 0 0 1 2 1 2 2 1 0 0 2 0 0 0 1 46 13 1 0 0 0 0 0 9 18 3 3 3 3
3 3 3 3 17 10 12 12 12 12 12 12 12 12 12 12 12 12 12 12 12 12 12 12 12 12 12 12 12 12 12 12 12 12 12 12 12 12 12 12 12 12 12 12 11 18 4 3 3 3
3 3 3 4 19 21 21 21 21 21 21 21 21 21 21 21 21 21 21 21 21 21 21 21 21 21 21 21 21 21 21 21 21 21 21 21 21 21 21 21 21 21 21 21 21 20 3 3 3 4
3 3 3 4 3 3 3 3 4 3 3 3 3 3 3 3 3 4 3 3 3 3 3 3 3 3 3 3 4 3 3 3 3 3 3 4 3 3 4 3 3 3 3 3 3 3 3 4 3 3
3 3 3 3 3 4 3 3 3 3 3 3 3 3 4 3 3 3 3 3 3 3 4 3 3 3 3 3 3 3 3 3 4 3 3 3 3 3 3 3 3 3 4 3 4 3 3 3 4 3
3 3 3 3 3 3 3 3 4 3 3 3 3 3 3 3 3 3 3 4 3 3 3 3 3 3 4 3 3 3 3 3 3 3 3 4 3 3 3 3 4 3 3 3 3 3 4 3 3 3
3 3 4 3 3 4 3 3 3 3 3 3 3 4 3 3 3 3 3 3 3 3 3 3 3 3 3 4 3 3 3 3 3 3 3 3 3 3 4 3 3 3 3 3 4 3 3 3 3 4